################################################################################
################################################################################
################################################################################
################################################################################
################################################################################
################################################################################
################################################################################
################################################################################
################################################################################
################################################################################
################################################################################
################################################################################
################################################################################
################################################################################
################################################################################
################################################################################
################################################################################
################################################################################
################################################################################
################################################################################
################################################################################
################################################################################
################################################################################
#################################################               ################
################################################                 ###############
#################################                                     ##########
################################                                       #########
########                                                                     ###
#####                                                                        ###
####                                                                         ###
###                                                                          ###
###                                                                          ###
###                                                                          ###
###                                                                          ###
###                                                                          ###
###                                                                          ###
###                                                                          ###
###                                                                          ###
###                                                                          ###
###                                                                          ###
###                                                                          ###
###                                                                          ###
###                                                                          ###
###                                                                          ###
###                                                                          ###
###                                                                          ###
###                                                                          ###
###                                                                          ###
###                                                                          ###
###                                                                          ###
###                                                                          ###
###                                                                          ###
###                                                                          ###
###                                                                          ###
###                                                                          ###
###                                                                          ###
###                                                                          ###
###                                                                          ###
###                                                                          ###
################################################################################