################################################################################
################################################################################
################################################################################
################################################################################
################################################################################
################################################################################
################################################################################
################################################################################
################################################################################
################################################################################
################################################################################
################################################################################
################################################################################
################################################################################
################################################################################
################################################################################
################################################################################
###           ##################################################################
###            #################################################################
###             ################################################################
###              ###############################################################
###                ##################################                        ###
###                 #############################                            ###
###                   #######################                                ###
###                         ############                                     ###
###                         #####                                            ###
###                                                                          ###
###                                                                          ###
###                                                                          ###
###                                                                          ###
###                                                                          ###
###                                                                          ###
###                                                                          ###
###                                                                          ###
###                                                                          ###
###                                                                          ###
###                                                                          ###
###                                                                          ###
###                                                                          ###
###                                                                          ###
###                                                                          ###
###                                                                          ###
###                                                                          ###
###                                                                          ###
###                                                                          ###
###                                                                          ###
###                                                                          ###
###                                                                          ###
###                                                                          ###
###                                                                          ###
###                                                                          ###
###                                                                          ###
###                                                                          ###
###                                                                          ###
###                                                                          ###
###                                                                          ###
###                                                                          ###
###                                                                          ###
###                                                                          ###
################################################################################