################################################################################
################################################################################
################################################################################
###                                                                          ###
###                                                                          ###
###                                                                          ###
###                                                                          ###
###                                                                          ###
###                                                                          ###
###                                                                          ###
###                                                                          ###
###                                                                          ###
###                                                                          ###
###                                                                          ###
###                                                                          ###
###                                                                          ###
###                                                                          ###
###                                                                          ###
###                                                                          ###
###                                                                          ###
###                                                                          ###
###                                                                          ###
###                                                                          ###
###                                                                          ###
###                                                                          ###
###                                                                          ###
###                                                                          ###
###                                                                          ###
###                                                                          ###
###                                                                          ###
###                                                                          ###
###                                                                          ###
###                                                                          ###
###                                                                          ###
###                                                                          ###
###                                                                          ###
###                                                                          ###
###                                                                          ###
###                                                                          ###
###                                                                          ###
###                                                                          ###
###                                                                          ###
###                                                                          ###
###                                                                          ###
###                                                                          ###
###                                                                          ###
###                                                                          ###
###                                                                          ###
###                                                                          ###
###                                                                          ###
###                                                                          ###
###                                                                          ###
###                                                                          ###
###                                                                          ###
###                                                                          ###
###                                                                          ###
###                                                                          ###
################################################################################
################################################################################
################################################################################