################################################################################
################################################################################
################################################################################
################################################################################
################################################################################
################################################################################
################################################################################
################################################################################
################################################################################
################################################################################
################################################################################
################################################################################
#########################################         ##############################
#########################################          #############################
#########################################           ############################
#########################################           ############################
############################                        ############################
###########################                         ############################
##########################                           ###########################
#########################                            ###########################
########################                              ##########################
#######################                                #########################
######################                                  ########################
#####################                                   ########################
####################                                     #######################
###################                                       ######################
##################                                         #####################
#################                                           ####################
################                                             ###################
###############                                               ##################
##############                                                 #################
#############                                                   ################
############                                                     ###############
###########                                                       ##############
##########                                                         #############
#########                                                                    ###
########                                                                     ###
#######                                                                      ###
######                                                                       ###
#####                                                                        ###
####                                                                         ###
###                                                                          ###
###                                                                          ###
###                                                                          ###
###                                                                          ###
###                                                                          ###
###                                                                          ###
###                                                                          ###
###                                                                          ###
###                                                                          ###
###                                                                          ###
###                                                                          ###
###                                                                          ###
###                                                                          ###
###                                                                          ###
###                                                                          ###
###                                                                          ###
################################################################################
################################################################################
################################################################################